1111111111111111111
1222222221222222221
1211211121211121121
1311211121211121131
1222222222222222221
1211212111112121121
1222212221222122221
1111211101011121111
1111210ghjkl0121111
1111210111110121111
0000200111110020000
1111210111110121111
1111210000000121111
1111210111110121111
1222222221222222221
1211211121211121121
1321222222222221231
1121212111112121211
1222212221222122221
1211111121211111121
122222222p222222221
1111111111111111111
