11111111111111111111111111111
13222222222222122222222222231
11111121111112121111112111111
11111121111112121111112111111
12222222222222222222222222221
11111121211111111111212111111
12222221222222122222212222221
11111121111112121111112111111
11111121222222222222212111111
11111121211111111111212111111
12222222211111111111222222221
111111212222ghjkl222212111111
11111121211111111111212111111
12222222222222122222222222221
11111221111112121111112111111
12221222222222222222222122221
11121211211111111111212121111
13222221222222122222212222231
11111111111112121111111111121
12222222222222222222222222p21
11111111111111111111111111111
