11111111121111111111
13222222121122222231
12112112222221121121
12122212121121222121
12122222121121222121
12112112121121121121
12222222121122222221
12111111121111111121
1211111ghjkl22222221
12222222211111111211
11211112111222211211
12221222111211222221
22121212112221211122
12121212112121221121
12122212122121121121
12121112121121122121
12122222122222112121
13121111111212112231
1222222222221222p111
11111111121111111111
