11111111111111111
12222222122222221
12112112121121121
12122122222122121
12221121112112221
121112ghjkl211121
22222211111222222
12111222222211121
12221121112112221
12122122222122121
12112112121121121
122222221222222p1
11111111111111111
